0 0 0 0 0 0 0 0
0 3 1 1 1 1 4 0
0 2 0 0 0 0 2 0
0 2 0 0 0 0 2 0
0 5 1 1 1 1 6 0
0 0 0 0 0 0 0 0