3 1 8 1 1 1 4 0
2 0 2 0 0 0 2 0
15 0 5 1 13 0 2 0
0 14 0 0 0 0 2 0
12 10 1 1 8 1 6 0
0 0 0 0 2 0 0 0