3 1 8 1 1 8 1 4
2 0 2 0 0 2 0 2
7 1 11 1 1 11 1 9
2 0 2 0 0 2 0 2
2 0 2 0 0 2 0 2
5 1 10 1 1 10 1 6