1 8 1 1 1 8 13 0
0 2 0 0 0 2 0 0
12 9 0 12 1 11 1 4
0 2 0 0 0 2 0 2
0 5 4 0 0 2 0 2
0 0 5 1 1 10 1 6